Bulbasaur -> Ivysaur -> Venusaur@
Charmander -> Charmeleon -> Charizard@
Squirtle -> Wartortle -> Blastoise@
Caterpie -> Metapod -> Butterfree@
Weedle -> Kakuna -> Beedrill @
Pidgey -> Pidgeottto -> Pidgeot@
Rattata -> Raticate@
Spearow -> Fearow@
Ekans -> Arbok@
Pikachu -> Raichu@
Sandshrew -> Sandslash@
Nidoran(female) -> Nidorina -> Nidoqueen@
Nidoran(male) -> Nidorino -> Nidoking@
Clefairy -> Clefable@
Vulpix -> Ninetales@
Jigglypugg -> Wigglytuff@
Zubat -> Golbat@
Oddish -> Gloom -> Vileplume@
Paras -> Parasect@
Venonat -> Venomoth@
Diglett -> Dugtrio@
Meowth -> Persian@
Psyduck -> Golduck@
Mankey -> Primeape@
Growlithe -> Arcanine@
Poliwag -> Poliwhirl -> Poliwrath@
Abra -> Kadabra -> Alakazam@
Machop -> Machoke -> Machamp@
Bellsprout -> Weepinbell -> Victreebel@
Tentacool -> Tentacruel@
Geodude -> Graveler -> Golem@
Ponyta -> Rapidash@
Slowpoke -> Slowbro@
Magnemite -> Magneton@
Farfetch'd Doesn't evolve@
Doduo -> Dodrio@
Seel -> Dewgong@
Grimer -> Muk@
Shellder -> Cloyster@
Gastly -> Haunter -> Gengar@
Onix@
Drowzee -> Hypno@
Krabby -> Kingler@
Voltorb -> Electrode@
Exeggcute -> Exeggutor@
Cubone -> Marowak@
Hitmonlee Doesn't evolve@
Hitmonchan Doesn't evolve@
Lickitung@
Koffing -> Weezing@
Rhyhorn -> Rhydon@
Chansey@
Tangela@
Kangaskhan Doesn't evolve@
Horsea -> Seadra@
Goldeen -> Seaking@
Staryu -> Starmie@
Mr.Mime Doesn't evolve@
Scyther@
Jynx Doesn't evolve@
Electabuzz@
Magmar@
Tauros Doesn't evolve@
Magikarp -> Gyarados@
Lapras Doesn't evolve@
Ditto Doesn't evolve@
Eevee can evolve into Vaporeon, Jolteon, or Flareon@
Eevee -> Vaporeon@
Eevee -> Jolteon@
Eevee -> Flareon@
Porygon Doesn't evolve@
Omanyte -> Omastar@
Kabuto -> Kabutops@
Aerodactyl Doesn't evolve@
Snorlax Doesn't evolve@
Articuno Doesn't evolve@
Zapdos Doesn't evolve@
Moltres Doesn't evolve@
Dratini -> Dragonair -> Dragonite@
Mewtwo Doesn't evolve@
Mew Doesn't evolve@